gggggsswwww
gGGGGSSWWWw
gGXGGSSWWWw
gGGGGSSWWWw
gGGGSSWWWWw
gGCRCWWWWWw
gGSRWWWWWWw
sSSRWWWWWWw
sSWRWWWWWWw
wWWRWWWWWWw
wWWRWWWWWWw
wWWRWWSSSWw
wWWRWSSSSSs
wWSRSSGGGSs
sSCRCGGGGGg
sSGRGGGGGGg
gGGRGGGGGGg
gGNRNNZNNGg
nNNRNNNNNNn
nNNxNNNNNNn
nnnrnnnnnnn